"","UOGID","name","my_formula","allocation","formula_diff","pct_diff","rolled_up","pct_diff_rollup"
"1","010228","Birmingham",262198,483935,-221737,-45.82,262198,-45.82
"2","011542","Mobile",140082,196474,-56392,-28.7,140082,-28.7
"3","011560","Montgomery",130640,142483,-11843,-8.31,0,-100
"4","019073","Jefferson County",128744,155235,-26491,-17.07,0,-100
"5","019097","Mobile County",92264,135489,-43225,-31.9,0,-100
"6","019999","Alabama Nonentitlement",1425841,2486800,-1060959,-42.66,1777489,-28.52
"7","020078","Anchorage",412158,145258,266900,183.74,412158,183.74
"8","029999","Alaska Nonentitlement",365957,225884,140073,62.01,365957,62.01
"9","040186","Glendale",212610,189758,22852,12.04,212610,12.04
"10","040270","Mesa",292646,287998,4648,1.61,292646,1.61
"11","040330","Phoenix",1514628,1306316,208312,15.95,1514628,15.95
"12","040492","Tucson",580349,460731,119618,25.96,580349,25.96
"13","049013","Maricopa County",220840,239473,-18633,-7.78,220840,-7.78
"14","049019","Pima County",246510,233372,13138,5.63,246510,5.63
"15","049999","Arizona Nonentitlement",1625151,1685724,-60573,-3.59,1625151,-3.59
"16","059999","Arkansas Nonentitlement",1490189,2081178,-590989,-28.4,1490189,-28.4
"17","060078","Anaheim",719631,380081,339550,89.34,719631,89.34
"18","060228","Bakersfield",233452,287896,-54444,-18.91,233452,-18.91
"19","060324","Berkeley",291672,220578,71094,32.23,291672,32.23
"20","060720","Chula Vista",344221,159265,184956,116.13,344221,116.13
"21","061152","El Monte",442966,155203,287763,185.41,442966,185.41
"22","061230","Escondido",310922,135322,175600,129.76,310922,129.76
"23","061332","Fontana",149338,171346,-22008,-12.84,149338,-12.84
"24","061410","Fresno",631161,565293,65868,11.65,631161,11.65
"25","061440","Garden Grove",277492,174448,103044,59.07,277492,59.07
"26","061464","Glendale",266095,142237,123858,87.08,266095,87.08
"27","062088","Long Beach",1470626,507817,962809,189.6,1470626,189.6
"28","062118","Los Angeles",13819030,4496906,9322124,207.3,13819030,207.3
"29","062292","Modesto",264664,166397,98267,59.06,264664,59.06
"30","062367","Moreno Valley",166456,181852,-15396,-8.47,166456,-8.47
"31","062508","Oakland",1046219,640040,406179,63.46,1046219,63.46
"32","062556","Ontario",145469,160932,-15463,-9.61,145469,-9.61
"33","062622","Oxnard",370862,191905,178957,93.25,370862,93.25
"34","062724","Pasadena",364276,160921,203355,126.37,364276,126.37
"35","062850","Pomona",501897,181083,320814,177.16,501897,177.16
"36","063048","Riverside",275283,269677,5606,2.08,275283,2.08
"37","063144","Sacramento",544151,390322,153829,39.41,544151,39.41
"38","063162","Salinas",710435,178203,532232,298.67,710435,298.67
"39","063180","San Bernardino",310597,282349,28248,10,310597,10
"40","063210","San Diego",2342541,992604,1349937,136,2342541,136
"41","063228","San Francisco",3653265,1484425,2168840,146.11,3653265,146.11
"42","063258","San Jose",2254468,743498,1510970,203.22,2254468,203.22
"43","063342","Santa Ana",820717,489202,331515,67.77,820717,67.77
"44","063624","Stockton",396055,291273,104782,35.97,396055,35.97
"45","069001","Alameda County",248795,145247,103548,71.29,248795,71.29
"46","069013","Contra Costa County",740287,269776,470511,174.41,740287,174.41
"47","069019","Fresno County",260615,282160,-21545,-7.64,260615,-7.64
"48","069029","Kern County",359056,368923,-9867,-2.67,359056,-2.67
"49","069037","Los Angeles County",5021868,1856207,3165661,170.54,5021868,170.54
"50","069059","Orange County",417120,213433,203687,95.43,417120,95.43
"51","069065","Riverside County",547752,649342,-101590,-15.65,547752,-15.65
"52","069067","Sacramento County",603104,456547,146557,32.1,603104,32.1
"53","069071","San Bernardino County",549578,584769,-35191,-6.02,549578,-6.02
"54","069073","San Diego County",676955,326919,350036,107.07,676955,107.07
"55","069077","San Joaquin County",258918,220589,38329,17.38,258918,17.38
"56","069079","San Luis Obispo County",622475,148084,474391,320.35,622475,320.35
"57","069081","San Mateo County",456977,213481,243496,114.06,456977,114.06
"58","069083","Santa Barbara County",532152,142614,389538,273.14,532152,273.14
"59","069097","Sonoma County",664519,148183,516336,348.44,664519,348.44
"60","069099","Stanislaus County",284766,197836,86930,43.94,284766,43.94
"61","069999","California Nonentitlement",20141816,11827536,8314280,70.3,20141816,70.3
"62","080072","Aurora",319856,239252,80604,33.69,319856,33.69
"63","080288","Colorado Springs",353633,235877,117756,49.92,353633,49.92
"64","080390","Denver",811440,601992,209448,34.79,811440,34.79
"65","089001","Adams County",292050,146341,145709,99.57,292050,99.57
"66","089999","Colorado Nonentitlement",2478704,1815205,663499,36.55,2478704,36.55
"67","090102","Bridgeport",183800,248572,-64772,-26.06,183800,-26.06
"68","090492","Hartford",223034,292880,-69846,-23.85,223034,-23.85
"69","090726","New Haven",197976,313887,-115911,-36.93,197976,-36.93
"70","091194","Waterbury",116427,170015,-53588,-31.52,0,-100
"71","099999","Connecticut Nonentitlement",1307781,2179417,-871636,-39.99,1424208,-34.65
"72","100336","Wilmington",122230,186973,-64743,-34.63,0,-100
"73","109003","New Castle County",177952,195661,-17709,-9.05,177952,-9.05
"74","109999","Delaware Nonentitlement",126199,192991,-66792,-34.61,374628,94.12
"75","119999","District Of Columbia",2053931,1236471,817460,66.11,2053931,66.11
"76","121236","Hialeah",231555,191041,40514,21.21,231555,21.21
"77","121968","Miami",579329,429274,150055,34.96,579329,34.96
"78","122292","Orlando",164764,166071,-1307,-0.79,164764,-0.79
"79","122724","St Petersburg",349002,142779,206223,144.43,349002,144.43
"80","123000","Tallahassee",209964,159582,50382,31.57,209964,31.57
"81","123012","Tampa",294883,249301,45582,18.28,294883,18.28
"82","129011","Broward County",249887,207584,42303,20.38,249887,20.38
"83","129021","Collier County",172218,184402,-12184,-6.61,172218,-6.61
"84","129031","Jacksonville-Duval Count",583659,501739,81920,16.33,583659,16.33
"85","129033","Escambia County",226036,148002,78034,52.73,226036,52.73
"86","129057","Hillsborough County",567370,528265,39105,7.4,567370,7.4
"87","129071","Lee County",196770,228418,-31648,-13.86,196770,-13.86
"88","129081","Manatee County",196906,145858,51048,35,196906,35
"89","129083","Marion County",234253,159344,74909,47.01,234253,47.01
"90","129086","Miami-Dade County",979582,985426,-5844,-0.59,979582,-0.59
"91","129095","Orange County",409324,491249,-81925,-16.68,409324,-16.68
"92","129099","Palm Beach County",552651,517694,34957,6.75,552651,6.75
"93","129101","Pasco County",420880,228192,192688,84.44,420880,84.44
"94","129103","Pinellas County",513072,216740,296332,136.72,513072,136.72
"95","129105","Polk County",195501,268683,-73182,-27.24,195501,-27.24
"96","129115","Sarasota County",181424,139763,41661,29.81,181424,29.81
"97","129117","Seminole County",115893,150470,-34577,-22.98,0,-100
"98","129127","Volusia County",245245,153603,91642,59.66,245245,59.66
"99","129999","Florida Nonentitlement",7531191,5098790,2432401,47.71,7647084,49.98
"100","130174","Atlanta",1341163,605049,736114,121.66,1341163,121.66
"101","130192","Augusta-Richmond County",174445,152133,22312,14.67,174445,14.67
"102","131968","Macon",99768,137517,-37749,-27.45,0,-100
"103","132916","Savannah",299060,189647,109413,57.69,299060,57.69
"104","139063","Clayton County",175726,201035,-25309,-12.59,175726,-12.59
"105","139067","Cobb County",188586,272208,-83622,-30.72,188586,-30.72
"106","139089","De Kalb County",402012,427116,-25104,-5.88,402012,-5.88
"107","139121","Fulton County",146010,178159,-32149,-18.05,146010,-18.05
"108","139135","Gwinnett County",391275,472648,-81373,-17.22,391275,-17.22
"109","139999","Georgia Nonentitlement",3201786,4194121,-992335,-23.66,3301554,-21.28
"110","150144","Honolulu",2187106,655892,1531214,233.46,2187106,233.46
"111","159999","Hawaii Nonentitlement",1096819,439415,657404,149.61,1096819,149.61
"112","169999","Idaho Nonentitlement",851218,1021185,-169967,-16.64,851218,-16.64
"113","171296","Chicago",3604404,6524439,-2920035,-44.76,3604404,-44.76
"114","171332","Cicero",70160,138745,-68585,-49.43,0,-100
"115","172238","Evanston",45907,144459,-98552,-68.22,0,-100
"116","175154","Oak Park",35066,135513,-100447,-74.12,0,-100
"117","175526","Peoria",89965,139993,-50028,-35.74,0,-100
"118","176000","Rockford",110129,185376,-75247,-40.59,0,-100
"119","179031","Cook County",535905,814055,-278150,-34.17,535905,-34.17
"120","179043","Du Page County",291179,288711,2468,0.85,291179,0.85
"121","179097","Lake County",163564,217190,-53626,-24.69,163564,-24.69
"122","179197","Will County",84153,138203,-54050,-39.11,0,-100
"123","179999","Illinois Nonentitlement",2347900,4713992,-2366092,-50.19,2783281,-40.96
"124","180954","Evansville",101226,220282,-119056,-54.05,0,-100
"125","181014","Fort Wayne",107243,173640,-66397,-38.24,0,-100
"126","181104","Gary",109445,276538,-167093,-60.42,0,-100
"127","181272","Hammond",63222,176903,-113681,-64.26,0,-100
"128","181404","Indianapolis",666054,739279,-73225,-9.9,666054,-9.9
"129","182886","South Bend",80917,211014,-130097,-61.65,0,-100
"130","189999","Indiana Nonentitlement",1735430,3636551,-1901121,-52.28,2197482,-39.57
"131","191362","Des Moines",231170,309179,-78009,-25.23,231170,-25.23
"132","194812","Sioux City",77788,135218,-57430,-42.47,0,-100
"133","199999","Iowa Nonentitlement",1140504,2523830,-1383326,-54.81,1218292,-51.73
"134","201776","Kansas City",146688,182274,-35586,-19.52,146688,-19.52
"135","203408","Topeka",140831,149571,-8740,-5.84,140831,-5.84
"136","203696","Wichita",227150,237011,-9861,-4.16,227150,-4.16
"137","209999","Kansas Nonentitlement",843986,1565179,-721193,-46.08,843986,-46.08
"138","211314","Lexington-Fayette",396143,184355,211788,114.88,396143,114.88
"139","211374","Louisville",485625,927562,-441937,-47.65,485625,-47.65
"140","219999","Kentucky Nonentitlement",1345608,2397901,-1052293,-43.88,1345608,-43.88
"141","220126","Baton Rouge",165275,262197,-96922,-36.97,165275,-36.97
"142","221296","New Orleans",568187,1019132,-450945,-44.25,568187,-44.25
"143","221650","Shreveport",117130,140060,-22930,-16.37,0,-100
"144","229051","Jefferson Parish",176966,217959,-40993,-18.81,176966,-18.81
"145","229999","Louisiana Nonentitlement",1280676,2315707,-1035031,-44.7,1397806,-39.64
"146","232484","Portland",97591,161232,-63641,-39.47,0,-100
"147","239999","Maine Nonentitlement",756315,1322743,-566428,-42.82,853906,-35.44
"148","240066","Baltimore",1058801,1688313,-629512,-37.29,1058801,-37.29
"149","249003","Anne Arundel County",133821,161647,-27826,-17.21,0,-100
"150","249005","Baltimore County",429494,326513,102981,31.54,429494,31.54
"151","249031","Montgomery County",532277,367901,164376,44.68,532277,44.68
"152","249033","Prince Georges County",475336,387732,87604,22.59,475336,22.59
"153","249999","Maryland Nonentitlement",1159879,1056568,103311,9.78,1293699,22.44
"154","250282","Boston",2186338,1449423,736915,50.84,2186338,50.84
"155","250396","Cambridge",181473,226064,-44591,-19.72,181473,-19.72
"156","250744","Fall River",137804,234095,-96291,-41.13,137804,-41.13
"157","251284","Lowell",209693,174382,35311,20.25,209693,20.25
"158","251302","Lynn",207887,208122,-235,-0.11,207887,-0.11
"159","251614","New Bedford",139529,224092,-84563,-37.74,139529,-37.74
"160","251650","Newton",108014,159211,-51197,-32.16,0,-100
"161","251992","Quincy",178796,152259,26537,17.43,178796,17.43
"162","252250","Somerville",65551,203461,-137910,-67.78,0,-100
"163","252340","Springfield",440101,319947,120154,37.55,440101,37.55
"164","252880","Worcester",255937,363513,-107576,-29.59,255937,-29.59
"165","259999","Massachusetts Nonentitlement",3168951,4498628,-1329677,-29.56,3342516,-25.7
"166","261638","Dearborn",41831,154947,-113116,-73,0,-100
"167","261698","Detroit",1016744,2838335,-1821591,-64.18,1016744,-64.18
"168","262172","Flint",145664,325669,-180005,-55.27,145664,-55.27
"169","262544","Grand Rapids",222382,316210,-93828,-29.67,222382,-29.67
"170","263222","Kalamazoo",108552,138353,-29801,-21.54,0,-100
"171","263456","Lansing",111236,167841,-56605,-33.73,0,-100
"172","265340","Saginaw",67194,183056,-115862,-63.29,0,-100
"173","269049","Genesee County",86468,154654,-68186,-44.09,0,-100
"174","269099","Macomb County",81570,152906,-71336,-46.65,0,-100
"175","269125","Oakland County",207487,329340,-121853,-37,207487,-37
"176","269161","Washtenaw County",186144,166266,19878,11.96,186144,11.96
"177","269163","Wayne County",148398,443330,-294932,-66.53,148398,-66.53
"178","269999","Michigan Nonentitlement",2227568,4697475,-2469907,-52.58,2724418,-42
"179","271266","Duluth",109550,198963,-89413,-44.94,0,-100
"180","273120","Minneapolis",814723,940966,-126243,-13.42,814723,-13.42
"181","274164","St Paul",470339,574696,-104357,-18.16,470339,-18.16
"182","279037","Dakota County",133083,150546,-17463,-11.6,0,-100
"183","279053","Hennepin County",277625,227202,50423,22.19,277625,22.19
"184","279137","St Louis County",82352,161676,-79324,-49.06,0,-100
"185","279999","Minnesota Nonentitlement",1308182,2064352,-756170,-36.63,1633167,-20.89
"186","280726","Jackson",164357,152848,11509,7.53,164357,7.53
"187","289999","Mississippi Nonentitleme",1149320,2233204,-1083884,-48.53,1149320,-48.53
"188","292670","Kansas City",428126,663295,-235169,-35.45,428126,-35.45
"189","294626","St Louis",488475,1473173,-984698,-66.84,488475,-66.84
"190","299189","St Louis County",278924,449802,-170878,-37.99,278924,-37.99
"191","299999","Missouri Nonentitlement",1788110,2559566,-771456,-30.14,1788110,-30.14
"192","309999","Montana Nonentitlement",766599,673738,92861,13.78,766599,13.78
"193","311710","Lincoln",259650,144736,114914,79.4,259650,79.4
"194","312208","Omaha",390916,386724,4192,1.08,390916,1.08
"195","319999","Nebraska Nonentitlement",435870,941814,-505944,-53.72,435870,-53.72
"196","320108","Las Vegas",978945,423286,555659,131.27,978945,131.27
"197","320138","North Las Vegas",371499,170642,200857,117.71,371499,117.71
"198","320150","Reno",264340,173783,90557,52.11,264340,52.11
"199","329003","Clark County",1339291,602765,736526,122.19,1339291,122.19
"200","329999","Nevada Nonentitlement",536316,420810,115506,27.45,536316,27.45
"201","330930","Manchester",149017,151302,-2285,-1.51,149017,-1.51
"202","339999","New Hampshire Nonentitlement",449056,863130,-414074,-47.97,449056,-47.97
"203","340414","Camden",145395,196244,-50849,-25.91,145395,-25.91
"204","340798","Elizabeth",312116,212254,99862,47.05,312116,47.05
"205","341464","Jersey City",313046,463919,-150873,-32.52,313046,-32.52
"206","342190","Newark",519456,586879,-67423,-11.49,519456,-11.49
"207","342454","Passaic",260547,145776,114771,78.73,260547,78.73
"208","342466","Paterson",249521,198039,51482,26,249521,26
"209","343216","Trenton",161891,213526,-51635,-24.18,161891,-24.18
"210","349003","Bergen County",335923,736329,-400406,-54.38,335923,-54.38
"211","349007","Camden County",141522,192421,-50899,-26.45,141522,-26.45
"212","349013","Essex County",285465,414730,-129265,-31.17,285465,-31.17
"213","349017","Hudson County",167703,166164,1539,0.93,167703,0.93
"214","349023","Middlesex County",155410,146045,9365,6.41,155410,6.41
"215","349025","Monmouth County",205005,198130,6875,3.47,205005,3.47
"216","349027","Morris County",152314,153439,-1125,-0.73,152314,-0.73
"217","349039","Union County",225008,361544,-136536,-37.76,225008,-37.76
"218","349999","New Jersey Nonentitlement",2408847,2772454,-363607,-13.11,2408847,-13.11
"219","350012","Albuquerque",477227,347265,129962,37.42,477227,37.42
"220","359999","New Mexico Nonentitlement",675836,1105350,-429514,-38.86,675836,-38.86
"221","360040","Albany",140941,276809,-135868,-49.08,140941,-49.08
"222","360556","Binghamton",46572,156982,-110410,-70.33,0,-100
"223","360784","Buffalo",277349,1137467,-860118,-75.62,277349,-75.62
"224","363160","Islip Town",168970,141470,27500,19.44,168970,19.44
"225","364436","New York",29011612,13625907,15385705,112.92,29011612,112.92
"226","364448","Niagara Falls",38324,201784,-163460,-81.01,0,-100
"227","365544","Rochester",256374,701419,-445045,-63.45,256374,-63.45
"228","365848","Schenectady",93793,185888,-92095,-49.54,0,-100
"229","366376","Syracuse",190477,414429,-223952,-54.04,190477,-54.04
"230","366468","Tonawanda Town",24162,136035,-111873,-82.24,0,-100
"231","366500","Troy",67419,148644,-81225,-54.64,0,-100
"232","366612","Utica",44600,195475,-150875,-77.18,0,-100
"233","367260","Yonkers",245169,284649,-39480,-13.87,245169,-13.87
"234","369029","Erie County",56351,217650,-161299,-74.11,0,-100
"235","369055","Monroe County",75991,149730,-73739,-49.25,0,-100
"236","369059","Nassau County",1009906,1146649,-136743,-11.93,1009906,-11.93
"237","369067","Onondaga County",68868,155767,-86899,-55.79,0,-100
"238","369087","Rockland County",177493,184623,-7130,-3.86,177493,-3.86
"239","369103","Suffolk County",215303,265013,-49710,-18.76,215303,-18.76
"240","369999","New York Nonentitlement",2992355,6079281,-3086926,-50.78,3508435,-42.29
"241","370558","Charlotte",653781,466608,187173,40.11,653781,40.11
"242","370828","Durham",268213,162711,105502,64.84,268213,64.84
"243","371188","Greensboro",182949,177096,5853,3.31,182949,3.31
"244","372304","Raleigh",307068,252923,54145,21.41,307068,21.41
"245","373180","Winston-Salem",207782,177368,30414,17.15,207782,17.15
"246","379183","Wake County",131623,137579,-5956,-4.33,0,-100
"247","379999","North Carolina Nonentitlement",3458939,4946338,-1487399,-30.07,3590562,-27.41
"248","389999","North Dakota Nonentitlement",540151,442064,98087,22.19,540151,22.19
"249","390042","Akron",228319,505219,-276900,-54.81,228319,-54.81
"250","390858","Canton",99463,212400,-112937,-53.17,0,-100
"251","391062","Cincinnati",387546,979871,-592325,-60.45,387546,-60.45
"252","391104","Cleveland",545479,1761226,-1215747,-69.03,545479,-69.03
"253","391176","Columbus",676506,580931,95575,16.45,676506,16.45
"254","391362","Dayton",237950,458258,-220308,-48.08,237950,-48.08
"255","392628","Lakewood",45484,164433,-118949,-72.34,0,-100
"256","394998","Springfield",50014,144902,-94888,-65.48,0,-100
"257","395214","Toledo",217038,610458,-393420,-64.45,217038,-64.45
"258","395874","Youngstown",98686,290747,-192061,-66.06,0,-100
"259","399035","Cuyahoga County",153529,303304,-149775,-49.38,153529,-49.38
"260","399049","Franklin County",174398,164136,10262,6.25,174398,6.25
"261","399061","Hamilton County",143270,259255,-115985,-44.74,143270,-44.74
"262","399113","Montgomery County",118666,150844,-32178,-21.33,0,-100
"263","399999","Ohio Nonentitlement",2360625,5763635,-3403010,-59.04,2772937,-51.89
"264","402268","Oklahoma City",523856,388987,134869,34.67,523856,34.67
"265","403036","Tulsa",324035,283807,40228,14.17,324035,14.17
"266","409999","Oklahoma Nonentitlement",1094182,1522558,-428376,-28.14,1094182,-28.14
"267","411098","Portland",1395657,702193,693464,98.76,1395657,98.76
"268","419005","Clackamas County",280689,179957,100732,55.98,280689,55.98
"269","419067","Washington County",210922,164525,46397,28.2,210922,28.2
"270","419999","Oregon Nonentitlement",3658692,1773057,1885635,106.35,3658692,106.35
"271","420096","Allentown",98755,192228,-93473,-48.63,0,-100
"272","422178","Erie",106642,252664,-146022,-57.79,0,-100
"273","422898","Harrisburg",90778,171823,-81045,-47.17,0,-100
"274","423573","Lancaster City",63189,140679,-77490,-55.08,0,-100
"275","425451","Philadelphia",2248177,3514942,-1266765,-36.04,2248177,-36.04
"276","425529","Pittsburgh",277040,1149245,-872205,-75.89,277040,-75.89
"277","425793","Reading",135429,221124,-85695,-38.75,135429,-38.75
"278","426201","Scranton",57384,226593,-169209,-74.68,0,-100
"279","429003","Allegheny County",318912,1129509,-810597,-71.77,318912,-71.77
"280","429007","Beaver County",60251,261824,-201573,-76.99,0,-100
"281","429011","Berks County",92023,184811,-92788,-50.21,0,-100
"282","429017","Bucks County",145534,152886,-7352,-4.81,145534,-4.81
"283","429029","Chester County",232235,204518,27717,13.55,232235,13.55
"284","429045","Delaware County",127716,296842,-169126,-56.98,0,-100
"285","429071","Lancaster County",123063,236616,-113553,-47.99,0,-100
"286","429079","Luzerne County",64109,345620,-281511,-81.45,0,-100
"287","429091","Montgomery County",165544,264975,-99431,-37.52,165544,-37.52
"288","429125","Washington County",77371,285588,-208217,-72.91,0,-100
"289","429129","Westmoreland County",85770,286197,-200427,-70.03,0,-100
"290","429133","York County",97080,178413,-81333,-45.59,0,-100
"291","429999","Pennsylvania Nonentitlement",2071095,5565646,-3494551,-62.79,3215225,-42.23
"292","440210","Pawtucket",62683,162426,-99743,-61.41,0,-100
"293","440222","Providence",187893,440396,-252503,-57.34,187893,-57.34
"294","440306","Woonsocket",41592,104388,-62796,-60.16,0,-100
"295","449999","Rhode Island Nonentitlement",303437,671713,-368276,-54.83,407711,-39.3
"296","459019","Charleston County",88208,142479,-54271,-38.09,0,-100
"297","459045","Greenville County",197122,216312,-19190,-8.87,197122,-8.87
"298","459051","Horry County",202053,203303,-1250,-0.61,202053,-0.61
"299","459999","South Carolina Nonentitlement",2024386,2524729,-500343,-19.82,2112594,-16.32
"300","469999","South Dakota Nonentitlement",471083,574427,-103344,-17.99,471083,-17.99
"301","470336","Chattanooga",123922,148904,-24982,-16.78,0,-100
"302","471242","Memphis",599293,561939,37354,6.65,599293,6.65
"303","471368","Nashville-Davidson",785057,416420,368637,88.53,785057,88.53
"304","479999","Tennessee Nonentitlement",2547580,2932401,-384821,-13.12,2671502,-8.9
"305","480222","Arlington",257405,262287,-4882,-1.86,257405,-1.86
"306","480264","Austin",899114,637196,261918,41.1,899114,41.1
"307","480726","Brownsville",170538,229510,-58972,-25.69,170538,-25.69
"308","481206","Corpus Christi",172516,221468,-48952,-22.1,172516,-22.1
"309","481338","Dallas",1229736,1211466,18270,1.51,1229736,1.51
"310","481680","El Paso",451768,565798,-114030,-20.15,451768,-20.15
"311","481896","Fort Worth",493449,570031,-76582,-13.43,493449,-13.43
"312","481998","Garland",127493,165656,-38163,-23.04,0,-100
"313","482514","Houston",2173115,2012200,160915,8,2173115,8
"314","482628","Irving",184684,185456,-772,-0.42,184684,-0.42
"315","483042","Laredo",249838,311462,-61624,-19.79,249838,-19.79
"316","483288","Lubbock",114613,174195,-59582,-34.2,0,-100
"317","484068","Pasadena",137031,143476,-6445,-4.49,137031,-4.49
"318","484758","San Antonio",1173416,1047124,126292,12.06,1173416,12.06
"319","489029","Bexar County",177587,189629,-12042,-6.35,177587,-6.35
"320","489039","Brazoria County",99085,144977,-45892,-31.65,0,-100
"321","489113","Dallas County",129149,171611,-42462,-24.74,0,-100
"322","489157","Fort Bend County",130080,200060,-69980,-34.98,0,-100
"323","489201","Harris County",737044,1074194,-337150,-31.39,737044,-31.39
"324","489215","Hidalgo County",384010,658339,-274329,-41.67,384010,-41.67
"325","489339","Montgomery County",115364,195580,-80216,-41.01,0,-100
"326","489439","Tarrant County",238585,219630,18955,8.63,238585,8.63
"327","489999","Texas Nonentitlement",5278641,8817205,-3538564,-40.13,5994425,-32.01
"328","491092","Salt Lake City",299557,290179,9378,3.23,299557,3.23
"329","499035","Salt Lake County",233819,207331,26488,12.78,233819,12.78
"330","499999","Utah Nonentitlement",823248,1239222,-415974,-33.57,823248,-33.57
"331","509999","Vermont Nonentitlement",507245,636450,-129205,-20.3,507245,-20.3
"332","511116","Norfolk",212873,348293,-135420,-38.88,212873,-38.88
"333","511308","Richmond",220729,375498,-154769,-41.22,220729,-41.22
"334","511320","Roanoke",92457,138286,-45829,-33.14,0,-100
"335","511590","Virginia Beach",155413,156528,-1115,-0.71,155413,-0.71
"336","519059","Fairfax County",618307,438751,179556,40.92,618307,40.92
"337","519087","Henrico County",110290,141855,-31565,-22.25,0,-100
"338","519153","Prince William County",236543,191206,45337,23.71,236543,23.71
"339","519999","Virginia Nonentitlement",1957149,2754274,-797125,-28.94,2159896,-21.58
"340","531392","Seattle",2263793,819850,1443943,176.12,2263793,176.12
"341","531488","Spokane",251774,269876,-18102,-6.71,251774,-6.71
"342","531554","Tacoma",238426,201163,37263,18.52,238426,18.52
"343","539033","King County",1049760,314480,735280,233.81,1049760,233.81
"344","539053","Pierce County",257444,225317,32127,14.26,257444,14.26
"345","539061","Snohomish County",325952,237184,88768,37.43,325952,37.43
"346","539999","Washington Nonentitlement",3766540,2500872,1265668,50.61,3766540,50.61
"347","540666","Huntington",58488,138369,-79881,-57.73,0,-100
"348","549999","West Virginia Nonentitlement",770008,1541846,-771838,-50.06,828497,-46.27
"349","553944","Madison",215537,149702,65835,43.98,215537,43.98
"350","554340","Milwaukee",653110,1333236,-680126,-51.01,653110,-51.01
"351","555424","Racine",56367,156205,-99838,-63.91,0,-100
"352","559999","Wisconsin Nonentitlement",1980926,3446076,-1465150,-42.52,2037293,-40.88
"353","569999","Wyoming Nonentitlement",354838,311565,43273,13.89,354838,13.89
"354","729021","Bayamon Municipio",195340,213845,-18505,-8.65,195340,-8.65
"355","729025","Caguas Municipio",132786,150294,-17508,-11.65,0,-100
"356","729031","Carolina Municipio",155088,177616,-22528,-12.68,155088,-12.68
"357","729113","Ponce Municipio",230838,233512,-2674,-1.15,230838,-1.15
"358","729127","San Juan Municipio",728493,565552,162941,28.81,728493,28.81
"359","729999","Puerto Rico Nonentitlement",2672465,3838845,-1166380,-30.38,2805252,-26.92
"360","600001","American Samoas",NA,79315,NA,NA,NA,NA
"361","660001","Guam",NA,234233,NA,NA,NA,NA
"362","690001","Northern Mariana Islands",NA,74900,NA,NA,NA,NA
"363","780001","Virgin Islands",NA,151552,NA,NA,NA,NA
